

    EA       ./textures/bluestone.xpm
     F 50,30,30
   NO  ./textures/greystone.xpm

   
  
C      155,213,225

    SO     ./textures/redbrick.xpm

WE     ./textures/wood.xpm

  111111111111111111111111111111111111111111111111111111111111
110000000001110100000000011111000000000000000011111000000000001
100000E000000000001110100010000001111100000000000000001111100001
1000000000000000001111101000000001111100000000000000001  1100001
10001110100010000001  110000000000000000111110000000000110000001
10000000000000001111  101000000111110000000000000000111110000001
1000001110101000000111111100000000000000001111100000000000000001
1000000000011100010100000011111000000000000000011111000000011111
10000000000000000000000000010100000011111000000000000000011
1000011101010100000011111000000000000000011111000000000000011111
100000000000000111000100000000111110000000110000000111110000011
110011101010100000111 11000000000000000111  10000000000011111
  1111000000111111 1111111000000100000011111100000011111
  1111100000011111111 1111000000111000001  111111111111111
  111110000001111 11111000000111  11110001111111111
  111111100000011 111100000011111111  1000000000000111111111
  111111000000111 111111110000001111  1100001111100001
  11000000111111111 1111100000011111  1000000111111111
  1110000001111 11110000000000011  11111000000111
  1111000000111  11 11110000001111  1111111100000111
  11111100000011 111111100000011111  1100011000000011
  11111111111111 1111 1111111111111  11111  111111111111111
    

  