EA ./textures/greystone.xpm
NO ./textures/redbrick.xpm
SO ./textures/bluestone.xpm
WE ./textures/wood.xpm

F 50,30,30 
C 155,213,225

1111111111111111111111111111111111111111111111111111111111111111
1000000000011101010100000011111000000000000000011111000000000001
1000000000000000001110101010000001111100000000000000001111100001
1000000100000000001110101010000001111100000000000000001111100001
1000001 10101000000111110000000000000000111110000000000000000001
1000000100000000111010101000000111110000000000000000111110000001
1000001110101010000001111100000000000000001111100000000000000001
1000000000011101010100000011111000000000000000011111000000000001
1000000000000000000001110101010000001111100000000000000001111101
1000011101010100000011111000000000010000011111000000000000000001
1000000000000001110101010000001111101001000000000001111100000001
1000111010101000000111110000000100010011111110000000000000000001
 11111111111111111111111111111111111111111111111111111111111111