

    EA    ./textures/bluestone.xpm
   NO ./textures/bluestone.xpm
SO   ./textures/bluestone.xpm

WE ./textures/bluestone.xpm

 F 255,255,255
  
C 17,254,0
 
 111      111
  1  1
 1111  1
11 11
 11E1
 111

 
    