

    EA    ./textures/greystone.xpm
   NO ./textures/redbrick.xpm
SO   ./textures/bluestone.xpm
WE ./textures/wood.xpm

 F 50,30,30
  
C 155,213,225

111111111111111111111111
100001000100000110000011
1000W1111000000000100011
111000000000010000000001
111000000000010000000001
111000010100010000000001
111000010100000000000001
111000010100000001111101
111000000000000000000001
111111111111111111111111

