

    EA    ./textures/greystone.xpm
   NO ./textures/redbrick.xpm
SO   ./textures/bluestone.xpm
WE ./textures/wood.xpm

 F 50,30,30
  
C 17,254,0

11111111111
10000000001
10000000001
10000000001
10000W00011
10000000001
10000000001
11111111111