

    EA    ./textures/greystone.xpm
   NO ./textures/redbrick.xpm
SO   ./textures/wood.xpm

WE ./textures/bluestone.xpm

 F 255,255,255
  
C 17,254,0

1111111111111111 
1000000000000001
10000000000000011
1100000N000000001
10000000000000011
1000000000000001
1000000000000001
1111111111111111

 
    