

    EA    ./textures/muro.xpm
   NO ./textures/redbrick.xpm
SO   ./textures/bluestone.xpm
WE ./textures/wood.xpm

 F 50,30,30
  
C 17,254,0

111111111111111111111111111111111111111
100011000000000000000000000111000000001
1000000000000000000011100000000000000011 
111000000000000000000000000000000111000011 
1100100000000000111000111000000000000111
11100000000000000111000000000000000011111
100000000000000000000011100000000100011101
100000001110000000001111111000000001111111
1000000111000000111100000000000000001011
100000000000000000111000011101111111000111
100000000000011100111100000000000100111001
100000010001111000011100000W000000011111111
100000011100001110000111000000000111101111
10000000000000000111101110000000000111
100000000011110000000001110000000000001
10000000000000111100011110011111000000111
100000000000000000000000000001111001111
100000000001111000111100000000000000001
100000000000000000000000000000000011111
100000000000000000000000000000000000001
100000000000000000011110000000000000001
1111111111111111111111111111111111111111