

    EA    ./textures/greystone.xpm
   NO ./textures/redbrick.xpm
SO   ./textures/bluestone.xpm

WE ./textures/wood.xpm

 F 50,30,30
  
C 50,120,254
 
1111111111111111
1000000000000001
11000S0100000001
1000010000000001
1111111111111111

 
    