

    EA    ./textures/bluestone.xpm
   NO ./textures/bluestone.xpm
SO   ./textures/bluestone.xpm

WE ./textures/bluestone.xpm

 F 255,255,255
  
C 17,254,0
 
1111111111111111
1000000000000001
11000E0000000001
1000000000000001
1111111111111111

 
    