

    EA    ./textures/east.xpm
   NO ./textures/north.xpm
SO   ./textures/south.xpm

WE ./textures/west.xpm

 F 255,255,255
  
C 17,254,0
 
 111      111
  1  1
 1111  1
11 11
 11S1
 111

 
    