

    EA    ./textures/greystone.xpm
   NO ./textures/redbrick.xpm
SO   ./textures/bluestone.xpm
WE ./textures/wood.xpm

 F 50,30,30
  
C 17,254,0

1111111111
1000110001
1000000001 
1100000001    
1100E00011
1100000001
1000000001
1111111111