

    EA    ./textures/greystone.xpm
   NO ./textures/redbrick.xpm
SO   ./textures/bluestone.xpm
WE ./textures/wood.xpm

 F 50,30,30
  
C 155,213,225

111111111111111111111111111111111111111
100000000000000000000000000000000000001
100000001110000000000000000000000000001
100000000000000000001110000001110000001
100001110000000000000000000000000000001
100000000000111001110000001111000000001
100000000001110000000000000000000000001
100000000111000000000001110000001110001
100111000000000001110000000000000000001
1000000000000001110000000000N0000000001
111000000000001110000000000000000000001
100000000000000111000000111000000000001
100000111000000000001110000000000000001
100000000000111000000111111000000000001
100000111000000000000000000000000000001
100000000000001110111111000111000000001
100111000000000000000000000000000000001
100000000001110000000000000111000000111
111111111111111111111111111111111111111