NO  img/ael-bekk.xpm
SO img/mel-hada.xpm
WE img/mabenchi.xpm
EA img/zboudair.xpm
11111111111111111111111111111111111
11111111111111111111111111111111111
11111000000000000000000000111111111
11111000000000000001000000001111111
11111000000000000000000000001111111
11111010p00000000000000000001111111
11111000000000001000000000001111111
11111000000000000000000000011111111
11111010110000000000000000000111111
11111000000000000000000000011111111
11111001000000000000000000001111111
11111000000000000000000000001111111
11111111111111111111111111111111111
11111111111111111111111111111111111
11111111111111111111111111111111111