

    EA    ./textures/bluestone.xpm
   NO ./textures/bluestone.xpm
SO   ./textures/bluestone.xpm

WE ./textures/bluestone.xpm

 F 255,255,255
  
C 17,254,0
 
111111111111
100000000001
11000E000001
100000000001
111111111111

 
    