

    EA    ./textures/east.xpm
   NO ./textures/north.xpm
SO   ./textures/south.xpm

WE ./textures/west.xpm

 F 255,255,255
  
C 17,254,0
 111111
  1S1  1
 11111
 11 11
 1111
 111
 