

    EA    ./textures/greystone.xpm
   NO ./textures/redbrick.xpm
SO   ./textures/bluestone.xpm
WE ./textures/wood.xpm

 F 50,30,30
  
C 17,254,0

111111111111111111111111111111111111111
100000000000000000000000000000000000001
100000000000000000000000000000000000001
100000000000000000000000000000000000001
100000000000000000000000000000000000001
1000000000000000000W0000000001000000001
100000000000000000000000000000000000001
100000000000000000000000000000000000001
100000000000000000000000000000000000001
100000000000000000000000000000000000001
1111111111111111111111111111111111111111