

    EA    ./textures/greystone.xpm
   NO ./textures/redbrick.xpm
SO   ./textures/bluestone.xpm
WE ./textures/wood.xpm

 F 50,30,30
  
C 17,254,0

111111
100001
1000E1
111111